@@@@@@@@@@@@@@@@@@@@@@@@@@@@@@@@@@@@@@@@@@@@@@@@@@@@@@@@@@@@@@@@@@@@@@@@@@@@@@@@@@@@@@@@@@@@@@@@@@@@
@                                                                                                  @
@                                                                                                  @
@                                                                                                  @
@                                                                                                  @
@                                                                                                  @
@                                                                                                  @
@                                                                                                  @
@                                                                                                  @
@                                                                                                  @
@                                                                                                  @
@                                                                                                  @
@                                                                                                  @
@                                                                                                  @
@                                                                                                  @ 
@                                                                                                  @
@                                                                                                  @
@                                                                                                  @
@                                                                                                  @
@                                                                                                  @
@                                                                                                  @
@                                                                                                  @
@                                                                                                  @
@                                                                                                  @
@                                                                                                  @
@                                                                                                  @
@                                                                                                  @
@                                                                                                  @
@                                                                                                  @
@@@@@@@@@@@@@@@@@@@@@@@@@@@@@@@@@@@@@@@@@@@@@@@@@@@@@@@@@@@@@@@@@@@@@@@@@@@@@@@@@@@@@@@@@@@@@@@@@@@@
